SYSMLID = "sysmlId";
NAME = "name";
DESCRIPTION = "description";
OWNERID = "ownerId";
SOURCEID = "sourceId";
TARGET = "targetId";
TYPE = "type";
TYPEID = "typeId";
VALUEID = "valueId";
ENDAPATHIDS = "endAPathIds";
ENDBPATHIDS = "endBPathIds";
APPLIEDSTEREOTYPEINSTANCEID = "appliedStereotypeInstanceId";
OWNEDATTRIBUTEIDS = "ownedAttributeIds";
CLASSIFIERIDS = "classifierIds";
PROPERTYTYPE = "propertyType";
DEFININGFEATUREID = "definingFeatureId";
AGGREGATION = "aggregation";
MEMBERENDIDS = "memberEndIds";
OWNEDENDIDS = "ownedEndIds";
SLOTIDS = "slotIds";
ELASTICID = "_elasticId";
QUALIFIEDID = "_qualifiedId";
QUALIFIEDNAME = "_qualifiedName";
SITECHARACTERIZATIONID = "_siteCharacterizationId";
CONTENTS = "_contents";
PROPERTIES = "_properties";
SLOTS = "_slots";
RELATEDDOCUMENTS = "_relatedDocuments";
PARENTVIEWS = "_parentViews";
SITES = "_sites";
ISSITE = "_isSite";
CHILDVIEWS = "_childViews";
APPLIEDSTEREOTYPEIDS = "_appliedStereotypeIds";
EDITABLE = "_editable";
CREATOR = "_creator";
CREATED = "_created";
MODIFIER = "_modifier";
MODIFIED = "_modified";
